11111111111111111111
10001000000000000001
10101011000010001011
10100010000010001001
10111110000010000001
10001000100001100001
10001000100100011101
10001000100010010001
10001000000011000001
10001111100000001001
10001000100000010101
10100000111000010001
10101000001000010001
10101000101000000001
10001010101010000111
10000000100010000101
10001000111110000001
10001001000000001001
10001000010000001001
11111111111111111100